name Holes
win 2
....E..........
..    ......G..
...    ........
....  .........
..E.......   ..
..........  ...
...   .........
...........G...